    XX* X XX*   
 *   XX X* XX X*
     X     X    
  X  X  X      X
  X  *  XXXX    
    X        *  
    X    *    X 
  X X*X  X    X 
  XXX X  XX*  X 
      X *     X 
  X XXX XXXXXXX 
  X  *   X      
* X X  X XX XXXX
  X X  X* X X   
XXX XXXXXXX X  *
*    X *    X     
